111111111111111111111111111111
100000000100000C000000000000E1
10000C00000000000000C000000001
100000000100000000001111C00001
10000000C10000C000000000000001
100000000100000000000000000C01
10C000000000000000000000101111
10000000000000000C000000100001
100C0000010000P0000000001000C1
111111111111111111111111111111